################################################################
#####--------------------------##--------------------------#####
#####--------------------------##--------------------------#####
#####--------------------------##--------------------------#####
#####--------------------------##--------------------------#####
#####----######----########----##----########----######----#####
#####----######----########----##----########----######----#####
#####----######----########----##----########----######----#####
#####----######----########----##----########----######----#####
#####------------------------------------------------------#####
#####------------------------------------------------------#####
#####------------------------------------------------------#####
#####------------------------------------------------------#####
#####----######----##----##############----##----######----#####
#####----######----##----##############----##----######----#####
#####--------------##----------##----------##--------------#####
#####--------------##----------##----------##--------------#####
#####--------------##----------##----------##--------------#####
#####--------------##----------##----------##--------------#####
###############----########----##----########----###############
####----------#----########----##----########----#----------####
####----------#----##----------------------##----#----------####
####----------#----##----------------------##----#----------####
####----------#----##----------------------##----#----------####
####----------#----##----------------------##----#----------####
####----------#----##----##############----##----#----------####
###############----##----#------------#----##----###############
-------------------------#------------#-------------------------
-------------------------#------------#-------------------------
-------------------------#------------#-------------------------
-------------------------#------------#-------------------------
###############----##----#------------#----##----###############
####----------#----##----##############----##----#----------####
####----------#----##----------------------##----#----------####
####----------#----##----------------------##----#----------####
####----------#----##----------------------##----#----------####
####----------#----##----------------------##----#----------####
####----------#----##----##############----##----#----------####
###############----##----##############----##----###############
#####--------------------------##--------------------------#####
#####--------------------------##--------------------------#####
#####--------------------------##--------------------------#####
#####--------------------------##--------------------------#####
#####----######----########----##----########----######----#####
#####----######----########----##----########----######----#####
#####--------##----------------------------------##--------#####
#####--------##----------------------------------##--------#####
#####--------##----------------------------------##--------#####
#####--------##----------------------------------##--------#####
#########----##----##----##############----##----##----#########
#########----##----##----##############----##----##----#########
#####--------------##----------##----------##--------------#####
#####--------------##----------##----------##--------------#####
#####--------------##----------##----------##--------------#####
#####--------------##----------##----------##--------------#####
#####----##################----##----##################----#####
#####----##################----##----##################----#####
#####------------------------------------------------------#####
#####------------------------------------------------------#####
#####------------------------------------------------------#####
#####------------------------------------------------------#####
################################################################